uuhuk	ӯьук
uuhuuk	ӯьӯк
ahaa	агā
ahaam	агāм
aahaaleketiiq	āгāлыкытӣқ
aahaangwliq	āгāӱңлиқ
ahaaw	агāӱ
ahay	агаӥ
ihi	иьи
ihihihiy	иьиьиьиӥ
ihihihiyagh-	иьиьиьияӷ-
ihik	иьик
wu-hu-hu-hu-huu	ӱу-гу-гу-гу-гӯ
ahaamangam	агāмаңам
saaphanghilnguq*	ся̄пҳанӷилңуқ
huuy 	гӯӥ
haam	гāм
haaw 	гāӱ
hay 	гаӥ
huk	гук
huusae	гӯсяы
haamangam	гāмаңам
heng	гың
haatwarae	гāтӱараы
haanta	гāнта
